0 0 0 0 0 0 0 0 0 0 0 0 0 0 0 0 0 0 0 0 0 0 0 0 0 0 0 0 0 0 0 0 0 0 0 0 0 0 0 0 0  0 0 0 0 0 0 0 0 0 0 0 0 0 0 0 0 0 0 0 0 0 0 0 0 0 0 0 0 0 0 0 0 0  0 0 1 1 1 1 1 1 1 1 1 3 3 3 3 3 3 3 3  3 3 3 3 3  6 0 0 0 0 16 17 0 0 0 14 15 0 0 0 14 15 0 0 0 16 17 0 0 0 14 15 0 0 0 16 17   0 0 0 14 15 0 0 0 14 15 0 0 0 14 15 0 0 0 16 17 0 0 0 14 15 0 0 0 16 17 0 0 0 0  0  0 0 0 16 17 0 0 0 14 15 0 0 0 8 3 3  3 3 3 3 3 3 3 3 3 3 3 3 3 3 3 0 0 0 0 0 0 0 0 0 0 0 0 0 0  0 0 0 0 0 0 0 0 0 0 0 0 0 0 0 0 0 0 0 0 0 0 0 0 0 0 0 0 0 0 0 0 0 0 0 0  0 0 0 0 0 0 0 0 0 0 0 0 0 0 0 0 0 0 0 0 0 0 0 0 0 0 0 0 0 0  0 0 0 0 0 0 0 0 0 0  7   0 0 0 0 0 0 0 0 0 0 0 0 3 1 1 1 3 0 0 3 1 1 1 1 1 3 0 0 0 0 3 1 1 1 3 0 0 0 0 0 0 3 1 1  1 1 1 1 1 3 0 0 0 0 3  1 1 1 1 1 1 1 3 3 3 1 1 1 1 1 3 1 1 1 1 1 1 1 3 0 0 0 3 1 1 1 1  1 8  0 0 0 0 0 0 5 0 0 0 0 0 0 0 0 0 0 0 0 0 0 0 0 0
0 0 0 0 0 0 0 0 0 0 0 0 0 0 0 0 0 0 0 0 0 0 0 0 0 0 0 0 0 0 0 0 0 0 0 0 0 0 0 0 0  0 0 0 0 0 0 0 0 0 0 0 0 0 0 0 0 0 0 0 0 0 0 0 0 0 0 0 0 0 0 0 0 0  0 0 3 3 3 3 3 3 3 3 3 0 0 0 0 0 0 0 0  0 0 0 0 0  0 0 0 0 0 0  0  0 0 0 16 17 0 0 0 14 15 0 0 0 0  0  0 0 0 16 17 0 0 0 0  0    0 0 0 16 17 0 0 0 14 15 0 0 0 16 17 0 0 0 0  0  0 0 0 16 17 0 0 0 0  0  0 0 0 0  0  0 0 0 0  0  0 0 0 16 17 0 0 0 0 0 0  0 0 0 0 0 0 0 0 0 0 0 0 0 0 0 0 0 0 0 0 0 0 0 0 0 0 0 0 0  0 0 0 0 0 0 0 0 0 0 0 0 0 0 0 0 0 0 0 0 0 0 0 0 0 0 0 0 0 0 0 0 0 0 0 0  0 0 0 0 0 0 0 0 0 0 0 0 0 0 0 0 0 0 0 0 0 0 0 0 0 0 0 0 0 0  0 0 0 0 0 0 0 0 0 0  0   0 0 0 0 0 0 0 0 0 0 0 0 0 3 1 3 0 0 0 0 3 1 1 1 3 0 0 0 0 0 0 3 1 3 0 0 0 0 0 0 0 0 3 1  1 1 1 1 3 0 0 0 0 0 0  3 1 1 1 1 1 3 0 0 0 3 1 1 1 3 0 3 1 1 1 1 1 3 0 0 0 0 0 3 3 3 3  3 0  0 0 0 0 0 0 5 0 0 0 0 0 0 0 0 0 0 0 0 0 0 0 0 0
0 0 0 0 0 0 0 0 0 0 0 0 0 0 0 0 0 0 0 0 0 0 0 0 0 0 0 0 0 0 0 0 0 0 0 0 0 0 0 0 0  0 0 0 0 0 0 0 0 0 0 0 0 0 0 0 0 0 0 0 0 0 0 0 0 0 0 0 0 0 0 0 0 0  0 0 0 0 0 0 0 0 0 0 0 0 0 0 0 0 0 0 0  0 0 0 0 0  0 0 0 0 0 0  0  0 0 0 0  0  0 0 0 16 17 0 0 0 0  0  0 0 0 0  0  0 0 0 0  0    0 0 0 0  0  0 0 0 16 17 0 0 0 0  0  0 0 0 0  0  0 0 0 0  0  0 0 0 0  0  0 0 0 0  0  0 0 0 0  0  0 0 0 0  0  0 0 0 0 0 0  0 0 0 0 0 0 0 0 0 0 0 0 0 0 0 0 0 0 0 0 0 0 0 2 2 0 0 0 0  0 0 0 0 0 0 0 0 0 0 0 0 0 0 0 0 0 0 0 0 0 9 9 0 0 0 0 0 0 0 0 0 0 0 0 0  0 0 0 0 0 0 0 0 0 0 0 0 0 0 0 0 0 0 0 0 0 0 2 2 0 0 0 0 0 0  0 0 0 0 0 0 0 0 0 0  0   0 0 0 0 0 0 0 0 0 0 0 0 0 0 3 0 0 0 0 0 0 3 1 3 0 0 0 0 0 0 0 0 3 0 0 0 0 0 0 0 0 0 0 3  1 1 1 3 0 0 0 0 0 0 0  0 3 1 1 1 3 0 0 0 0 0 3 1 3 0 0 0 3 1 1 1 3 0 0 0 0 0 0 0 0 0 0  0 0  0 0 0 0 0 0 5 0 0 0 0 0 0 0 0 0 0 0 0 0 0 0 0 0
0 0 0 0 0 0 0 0 0 0 0 0 0 0 0 0 0 0 0 0 0 0 0 0 0 0 0 0 0 0 0 0 0 0 0 0 0 0 0 0 0  0 0 0 0 0 0 0 0 0 0 0 0 0 0 0 0 0 0 0 0 0 0 0 0 0 2 2 0 0 0 0 0 0  0 0 0 0 0 0 0 0 0 0 0 0 0 0 0 0 0 0 0  0 0 0 0 0  0 0 0 0 0 0  0  0 0 0 0  0  0 0 0 0  0  0 0 0 0  0  0 0 0 0  0  0 0 0 0  0    0 0 0 0  0  0 0 0 0  0  0 0 0 0  0  0 0 0 0  0  0 0 0 0  0  0 0 0 0  0  0 0 0 0  0  0 0 0 0  0  0 0 0 0  0  0 0 0 0 0 0  0 0 0 0 0 0 0 0 0 0 0 0 0 0 0 0 0 0 0 2 2 0 0 1 1 0 0 0 0  0 0 0 2 2 2 0 0 0 0 0 0 0 0 0 0 0 0 0 0 2 2 2 0 0 0 0 0 0 0 0 0 0 9 0 0  0 0 0 0 0 0 0 0 0 0 0 0 0 0 0 0 0 0 2 2 0 0 0 0 0 0 0 0 0 0  0 0 0 0 0 0 0 0 4 11 0   0 0 0 0 0 0 0 0 0 0 0 0 0 0 0 0 0 0 0 0 0 0 3 0 0 0 0 0 0 0 0 0 0 0 0 0 0 2 0 0 0 0 0 0  3 1 3 0 0 0 0 0 0 0 0  0 0 3 1 3 0 0 0 0 0 0 0 3 0 0 0 0 0 3 1 3 0 0 0 0 0 0 0 0 0 0 0  0 0  0 0 0 0 0 0 5 0 0 0 0 0 0 0 0 0 0 0 0 0 0 0 0 0
0 0 0 0 0 0 0 0 0 0 0 0 0 0 0 0 0 0 0 0 0 0 0 0 0 0 0 0 0 0 0 0 0 0 0 0 0 0 0 0 0  0 0 0 0 0 0 0 0 0 0 0 0 0 0 0 0 0 0 0 2 2 2 0 0 0 1 1 0 0 0 0 0 0  0 0 0 0 0 0 0 0 0 0 0 0 0 0 0 0 0 0 0  0 0 0 4 10 0 0 0 0 0 0  0  0 0 0 0  0  0 0 0 0  0  0 0 0 0  0  0 0 0 0  0  0 0 0 0  0    0 0 0 0  0  0 0 0 0  0  0 0 0 0  0  0 0 0 0  0  0 0 0 0  0  0 0 0 0  0  0 0 0 12 13 0 0 0 0  0  0 0 0 0  0  0 0 0 0 0 0  0 0 0 0 0 0 0 0 0 0 0 0 0 0 0 2 2 0 0 1 1 0 0 1 1 0 0 2 2  0 0 0 0 0 0 0 0 0 0 0 0 0 0 0 0 0 0 0 0 0 0 0 0 0 0 0 0 0 0 0 2 2 2 0 0  0 0 0 0 0 0 0 0 0 0 0 0 0 0 0 0 0 0 0 0 0 0 0 0 0 2 2 0 0 0  0 0 0 2 2 2 2 2 2 2  0   0 0 0 0 0 0 0 0 0 0 0 0 0 0 0 0 0 0 0 0 0 0 0 0 0 0 0 0 2 0 0 0 0 0 0 0 2 1 2 0 0 0 0 0  0 3 0 0 0 0 0 0 0 0 0  0 0 0 3 0 0 0 0 0 0 0 0 0 0 0 0 0 0 0 3 0 0 0 0 0 2 0 0 0 0 0 0  0 0  0 0 0 0 0 0 5 0 0 0 0 0 0 0 0 0 0 0 0 0 0 0 0 0
0 0 0 0 0 0 0 0 0 0 0 0 0 0 0 0 0 0 0 0 0 0 0 0 0 0 0 0 0 0 0 0 0 0 0 0 0 0 0 0 0  0 0 0 0 0 0 0 0 0 0 0 0 0 2 2 2 0 0 0 1 1 1 0 0 0 1 1 0 0 0 0 0 0  0 0 0 0 0 0 0 0 2 2 2 2 2 2 2 2 2 2 2  2 2 2 2 2  0 0 0 0 0 12 13 0 0 0 0  0  0 0 0 0  0  0 0 0 12 13 0 0 0 0  0  0 0 0 12 13   0 0 0 0  0  0 0 0 0  0  0 0 0 0  0  0 0 0 12 13 0 0 0 0  0  0 0 0 12 13 0 0 0 14 15 0 0 0 12 13 0 0 0 0  0  0 0 0 0 0 0  0 0 0 0 0 0 0 0 0 0 0 2 2 0 0 1 1 0 0 1 1 2 2 1 1 0 0 0 0  0 0 0 0 0 0 0 0 0 0 0 0 0 2 2 2 0 0 0 0 0 0 0 0 0 0 0 0 0 0 0 0 0 0 0 0  2 2 2 0 0 0 0 2 2 2 0 0 0 0 2 2 2 0 0 0 0 0 0 0 0 0 0 0 0 0  0 0 0 0 0 0 0 0 0 0  0   0 0 0 0 0 0 0 0 0 2 0 0 0 0 0 0 0 0 0 0 0 0 0 0 0 0 0 2 1 2 0 0 0 0 0 2 1 1 1 2 0 0 0 0  0 0 0 0 0 0 2 0 0 0 0  0 0 0 0 0 0 0 0 2 0 0 0 0 0 0 0 0 0 0 0 0 0 0 0 2 1 2 0 0 0 0 0  0 0  0 0 0 0 0 0 5 0 0 0 0 0 0 0 0 0 0 0 0 0 0 0 0 0
0 0 0 0 0 0 0 0 0 0 9 0 0 0 0 0 0 0 0 9 9 0 0 0 0 0 0 0 0 0 0 0 9 0 0 0 0 9 0 0 0  0 9 0 0 0 0 0 2 2 2 2 0 0 1 1 1 0 0 0 1 1 1 0 0 0 1 1 0 0 0 2 2 0  0 0 2 2 2 2 2 2 1 1 1 1 1 1 1 1 1 1 1  1 1 1 1 1  0 0 0 0 0 14 15 0 0 0 12 13 0 0 0 0  0  0 0 0 14 15 0 0 0 12 13 0 0 0 14 15   0 0 0 12 13 0 0 0 0  0  0 0 0 12 13 0 0 0 14 15 0 0 0 12 13 0 0 0 14 15 0 0 0 14 15 0 0 0 14 15 0 0 0 12 13 0 0 0 0 4 10 0 0 0 0 0 0 0 2 2 0 0 1 1 0 0 1 1 2 2 1 1 1 1 1 1 0 0 0 0  0 0 9 9 9 0 0 0 0 0 0 0 0 0 0 0 0 0 0 0 0 0 0 0 0 0 0 2 2 2 0 0 0 0 0 0  0 0 0 0 0 0 0 0 0 0 0 0 0 0 0 0 0 0 0 0 0 0 0 0 0 0 0 0 2 2  2 0 0 0 0 0 0 0 0 0  0   0 0 0 0 0 0 0 0 2 1 2 0 0 0 0 0 0 0 2 0 0 0 0 0 0 0 2 1 1 1 2 0 0 0 2 1 1 1 1 1 2 0 0 0  0 0 0 0 0 2 1 2 0 0 0  0 0 0 0 0 0 0 2 1 2 0 0 0 0 0 2 0 0 0 0 0 0 0 2 1 1 1 2 0 0 0 0  4 11 0 0 0 0 0 0 5 0 0 0 0 0 0 0 0 0 0 0 0 0 0 0 0 0
2 2 2 2 2 2 2 2 2 2 2 2 2 2 2 2 2 2 2 2 2 2 2 2 2 2 2 2 2 2 2 2 2 2 2 2 2 2 2 2 2  2 2 2 2 2 2 2 1 1 1 1 0 0 1 1 1 0 0 0 1 1 1 0 0 0 1 1 0 0 0 1 1 0  0 0 1 1 1 1 1 1 1 1 1 1 1 1 1 1 1 1 1  1 1 1 1 1  0 0 0 0 0 14 15 0 0 0 14 15 0 0 0 12 13 0 0 0 14 15 0 0 0 14 15 0 0 0 14 15   0 0 0 14 15 0 0 0 12 13 0 0 0 14 15 0 0 0 14 15 0 0 0 14 15 0 0 0 14 15 0 0 0 14 15 0 0 0 14 15 0 0 0 14 15 0 0 0 0 2 2  2 2 2 2 2 2 2 1 1 0 0 1 1 2 2 1 1 1 1 1 1 1 1 1 1 0 0 0 0  0 0 2 2 2 0 0 0 2 2 2 0 0 0 0 0 0 0 0 0 0 0 0 0 0 0 0 0 0 0 0 0 0 0 0 0  0 0 0 0 0 0 0 0 0 0 0 0 0 0 0 0 0 0 0 0 0 0 0 0 0 0 0 0 0 0  0 0 0 0 0 0 0 0 0 0  0   0 0 0 0 0 0 0 2 1 1 1 2 0 0 0 0 0 2 1 2 0 0 0 0 0 2 1 1 1 1 1 2 0 2 1 1 1 1 1 1 1 2 0 0  0 0 0 0 2 1 1 1 2 0 0  0 0 0 0 0 0 2 1 1 1 2 0 0 0 2 1 2 0 0 0 0 0 2 1 1 1 1 1 2 2 2 2  2 2  2 2 2 2 2 2 2 2 2 2 2 2 2 2 2 2 2 2 2 2 2 2 2 2
1 1 1 1 1 1 1 1 1 1 1 1 1 1 1 1 1 1 1 1 1 1 1 1 1 1 1 1 1 1 1 1 1 1 1 1 1 1 1 1 1  1 1 1 1 1 1 1 1 1 1 1 0 0 1 1 1 0 0 0 1 1 1 0 0 0 1 1 0 0 0 1 1 0  0 0 1 1 1 1 1 1 1 1 1 1 1 1 1 1 1 1 1  1 1 1 1 1  0 0 0 0 0 14 15 0 0 0 14 15 0 0 0 14 15 0 0 0 14 15 0 0 0 14 15 0 0 0 14 15   0 0 0 14 15 0 0 0 14 15 0 0 0 14 15 0 0 0 14 15 0 0 0 14 15 0 0 0 14 15 0 0 0 14 15 0 0 0 14 15 0 0 0 14 15 0 0 0 0 1 1  1 1 1 1 1 1 1 1 1 2 2 1 1 1 1 1 1 1 1 1 1 1 1 1 1 0 0 0 0  0 0 0 0 0 0 0 0 0 0 0 0 0 0 0 0 0 2 2 2 0 0 0 2 2 2 0 0 0 0 0 0 0 0 0 0  0 0 0 0 0 0 0 0 0 0 0 0 0 0 0 0 0 0 0 0 0 0 0 0 0 0 0 0 0 0  0 0 0 0 0 0 0 0 0 0  0   0 0 0 0 0 0 2 1 1 1 1 1 2 0 0 0 2 1 1 1 2 0 0 0 2 1 1 1 1 1 1 1 2 1 1 1 1 1 1 1 1 1 2 0  0 0 0 2 1 1 1 1 1 2 0  0 0 0 0 0 2 1 1 1 1 1 2 0 2 1 1 1 2 0 0 0 2 1 1 1 1 1 1 1 1 1 1  1 1  1 1 1 1 1 1 1 1 1 1 1 1 1 1 1 1 1 1 1 1 1 1 1 1
1 1 1 1 1 1 1 1 1 1 1 1 1 1 1 1 1 1 1 1 1 1 1 1 1 1 1 1 1 1 1 1 1 1 1 1 1 1 1 1 1  1 1 1 1 1 1 1 1 1 1 1 0 0 1 1 1 0 0 0 1 1 1 0 0 0 1 1 0 0 0 1 1 0  0 0 1 1 1 1 1 1 1 1 1 1 1 1 1 1 1 1 1  1 1 1 1 1  0 0 0 0 0 14 15 0 0 0 14 15 0 0 0 14 15 0 0 0 14 15 0 0 0 14 15 0 0 0 14 15   0 0 0 14 15 0 0 0 14 15 0 0 0 14 15 0 0 0 14 15 0 0 0 14 15 0 0 0 14 15 0 0 0 14 15 0 0 0 14 15 0 0 0 14 15 0 0 0 0 1 1  1 1 1 1 1 1 1 1 1 1 1 1 1 1 1 1 1 1 1 1 1 1 1 1 1 0 0 0 0  0 0 0 0 0 0 0 0 0 0 0 0 0 0 0 0 0 0 0 0 0 0 0 0 0 0 0 0 0 0 0 0 0 0 0 0  0 0 0 0 0 0 0 0 0 0 0 0 0 0 0 0 0 0 0 0 0 0 0 0 0 0 0 0 0 0  0 0 0 0 0 0 0 0 0 0  0   0 0 0 0 0 2 1 1 1 1 1 1 1 2 0 2 1 1 1 1 1 2 0 2 1 1 1 1 1 1 1 1 1 1 1 1 1 1 1 1 1 1 1 2  0 0 2 1 1 1 1 1 1 1 2  0 0 0 0 2 1 1 1 1 1 1 1 2 1 1 1 1 1 2 0 2 1 1 1 1 1 1 1 1 1 1 1  1 1  1 1 1 1 1 1 1 1 1 1 1 1 1 1 1 1 1 1 1 1 1 1 1 1